Zawodnik,Gra przy siatce obronna i sytuacyjna,Atak,Odbior,Serwis,Wystawa,Sytuacyjne,Suma
Przemek,60,70,80,80,80,75,445
Wieslaw Janik,79,62,77,70,72,80,440
Michal Guzik,63,65,73,76,80,76,433
Marcin Janik,75,70,72,74,68,74,433
Robert Zapala,71,65,74,73,77,72,432
Piotrek Socha,59,75,72,77,70,65,418
Tomek,58,67,70,70,66,62,393
Sylwek Kołda,57,60,65,73,65,58,378
Sebastian,40,53,70,75,75,50,363
Paweł Zapala,48,50,55,70,50,55,328
Marcin Zapala,46,53,60,65,57,45,326
Wesoly,35,55,62,74,48,40,314
